41 41
.....#...................................
####.#.#########.#####.#################.
...#.#.....#...#.#...#.#.............#.#.
.#.#.#####.###.#.#.###.#.###########.#.#.
.#...#.........#.#.....#...#...#...#.#...
.#####.#########.#.#######.###.#.#.#.#.##
.#.....#...#.....#...#...#...#...#.#.#...
.#.#######.#.#######.#.#.###.#####.#.####
.#.......#.#.#.......#.#...#.....#.#.#...
.#######.#.#.###.#####.#.#######.#.#.#.#.
...#...#...#...#.#.....#.........#.#...#.
##.#.#.###.###.#.#.###############.#####.
...#.#...#.#.#.#.#...#.........#...#...#.
.#######.#.#.#.#####.#.#######.#.#.#.#.#.
...#...#.#.#.#.........#.....#...#.#.#...
##.#.#.#.#.#.#############.#######.#.###.
.#...#.#.......#.....#...#.........#.#...
.#####.#######.#.###.#.#.#####.#####.####
.....#...#.......#...#.#.....#.#...#.....
##.#.###.###.#########.#####.#.###.#####.
...#...#...#...#...#...#.#...#...#.#...#.
.#####.###.#####.#.#.###.#.#####.#.#.#.#.
.#...#.#.#...#...#...#...#...#...#.#.#...
.###.#.#.###.#.#######.#####.#.###.#.####
...#.#...#.#.#...#...#.....#.#...#.#.....
.#.#.###.#.#.###.#.#.###.#.#.###.#.#####.
.#.#.......#...#...#...#.#.#...#...#...#.
.#.#.#########.#.#####.#.#####.#####.#.#.
.#.#.#.........#.....#.#.....#.....#.#...
.#.#.#.###############.#.###.#####.#.###.
.#.#.#.#.............#.#...#.....#...#...
.#.###.#####.#######.#.#####.###.#####.##
.#...#.....#...#.....#.....#.#.#.....#...
.###.#####.###.#.#####.###.#.#.#.#.#####.
...#.....#.....#.....#...#.#...#.#.#.....
##.#####.###########.#####.###.#.#.#.####
...#...#.#.........#.....#.#...#.#.#...#.
.###.#.#.#.#####.#.#####.#.#.###.#####.#.
.#.#.#...#.#...#.#.....#.#.#.#.#...#.....
.#.#.#####.#.#.#.#######.#.#.#.###.#.###.
...#.........#.#...........#.....#.....#.
